NO ./include/assets/N.txt
WE ./include/assets/W.txt
EA ./include/assets/E.txt
SO ./include/assets/S.txt

F 220,100,0
C 225,30,0

11111111
10010001
11000001
10001001
10000001
10000N01
10000001
11111111
