jesuisuntest
jesuisuntest2

        1111111
111111111000011
10000000000111
100000110001
10000000000111
11111111111111





