NO ./include/assets/N.txt
WE ./include/assets/W.txt
EA ./include/assets/E.txt
SO ./include/assets/S.txt

F 220,100,0
C 225,30,0

111111
100101
100001
110001
100001
100N01
100001
111111
