NO ./include/assets/N.xpm
WE ./include/assets/W.xpm
EA ./include/assets/E.xpm
SO ./include/assets/S.xpm

F 20,12,1
C 2,5,41

1111111111111111111111111
1000000000110000000000001
1011000001110000000000001
1001000000000000000000001
111111111011000001110000011111111
100000000011000001110111111111111
11110111111111000000000000001
11110111111111011101010000001
11000000110101011100000000001
10000000000000000000000000001
10000000000000001101010N00001
1100000111010101111101110000111
11110111 1110101 101111010001
11111111 1111111 111111111111
